111111111
1P0000001
100010011
1C00100C1
100C1E1C1
111111111
