111111111
1P0000001
100010011
1C00100C1
100C1E001
111111111
