111111111111111
1P00000000C0001
100111001100001
100000000000001
111111000011101
1C0000C00000E01
100111001111101
100000000000001
10000000C000001
111111111111111
