1111111111111111111111111111111111111111
1P0000000000000C00000C0000000000000000C1
1010010100100000101001000000010101010101
1010010010101010001001000000010101000101
1C0000000C00C0000000000000000000C00000E1
1000000011111111111100000000111111111001
1010101000000000000010101010000000001001
1000000001111011111010000000000111111001
1011111010000000000010111111100000001001
1C0000000C0000000C0000000000000000000001
1111111111111111111111111111110011111111
1C000000000000000000000000000000000000C1
1011111111011111111111111011111111111101
1000000000000000000000000010000000000001
1000000001111100000011111111111111111001
1000000C000000000000000000000000000000C1
1001111011111111111111111111100000001001
1000000000000000000000000000000000011001
1C00000000000000000000000000000000000C01
1111111111111111111111111111111111111111
